8 10
.f........
...f..f...
..........
..........
s.........
.......f..
..........
........h.
