10 10
........b.
..........
.f........
.......fa.
........f.
.......f..
..........
........h.
..........
s.........
